222222222222222222222222
211111111111111111101112
222110111111111111201112
111111011111111111111112
222110111112211111101112
212111111122221111111112
212222111111111111101112
212222111111131111111112
222111111111111111111112
000111113111111111111112
011001111111131110000002
013111111100000001111112
011111311100111111112112
001111111300113111111112
001111111011111011110112
210011111111111111111112
211111111211112111112112
211111111111111111122222
222221111111111112222222
222222111111111111122222