00000000000000
00000000000000
00001111111100
00011111111100
00111111100000
01111111111110
01111111111110
01111100000000
00111110000000
00111111100000
00111111100000
00000001110000
00000000111100
01110000111110
01111000001110
01111111001110
01111111111110
01110011111100
01110011111000
00200000000000