00000000000000000000000000000000
00003000000000000333000002333000
00000000300003000313222221111000
03003000000000002222222223111000
00000000030000222222222220111100
00300003333300222222200000111100
00000000030001111222000300111100
01111000000011111111000300222200
01111100000011111100000000222200
01111100300011111100000011111100
01111100300011111000000011111100
02202200000021131100000011111100
02202200000011111100000011111100
02202222222201111100000002222000
02222222222111113100300002220000
02222222222111133300000303330300
00000000011111113100000001310000
00300000000111111100300003130000
00000030003000000000300001310000
00030000000000300000000003330000